*--*--*--*  
|  |  |  |  
*--*--*--*  
|  |  |  |  
*--*  *  *  
|     |  |  
*--*--*--*  
            
